000000000000000000000000000000
200000000000000000000000000002
100000000000000000000000000201
100000000000022200000000022101
100220000220000000000000211101
120000002112000000222202111001
110022221111222222111121100011
111000000000000000000000001111
111111111111111111111111111111